[
    {
        "Id": 0,
        "X": 7924,
        "Y": 7041,
        "Area": []
    },
    {
        "Id": 1,
        "X": 7186,
        "Y": 6950,
        "Area": []
    },
    {
        "Id": 2,
        "X": 7309,
        "Y": 5682,
        "Area": []
    },
    {
        "Id": 3,
        "X": 6808,
        "Y": 4777,
        "Area": []
    },
    {
        "Id": 4,
        "X": 7397,
        "Y": 4827,
        "Area": []
    },
    {
        "Id": 5,
        "X": 7610,
        "Y": 4304,
        "Area": []
    },
    {
        "Id": 6,
        "X": 7198,
        "Y": 3372,
        "Area": []
    }
]